20 20 20 20 20 20 20 20 20 20 20 20 20 20 20 20 20 20 20 20 20 20 20 20 20 20 20 20 20 20 20 20
20 16 16 16 16 16 16 16 16 16 16 16 16 16 16 16 12 12 12 12 12 12 12 12 12 12 12 12 12 12 12 20
20 16 16 16 16 16 16 16 16 16 16 16 16 16 16 16 12 12 12 12 12 12 12 12 12 12 12 20 20 20 12 20
20 16 16 16 12 12 12 21 21 21 21 21 21 21 21 21 21 21 21 21 21 21 21 21 12 12 12 12 12 12 20 20
20 16 16 16 12 12 12 21 21 21 21 21 21 21 21 21 21 21 21 21 21 21 21 21 12 12 12 12 12 12 20 20
20 21 21 21 21 21 21 21 12 12 12 12 12 12 20 20 20 20 20 20 20 20 20 12 12 12 12 12 12 12 20 20
20 16 16 21 21 16 16 16 12 12 12 12 12 12 20 15 15 15 15 15 15 15 15 20 12 12 12 12 12 12 18 20
20 12 16 21 21 16 12 12 12 12 20 21 21 21 17 15 15 15 15 15 15 15 15 15 20 20 20 20 14 20 19 20
20 12 16 21 21 16 12 12 12 12 20 21 21 21 17 15 15 15 15 15 15 15 15 15 15 15 15 15 14 15 15 20
20 12 16 21 21 16 12 12 12 12 20 21 21 21 17 15 15 15 15 15 15 15 15 15 15 15 15 15 14 15 15 20
20 12 16 21 21 16 12 12 12 12 20 21 21 21 17 12 12 12 12 16 16 16 12 16 16 16 16 16 12 12 12 20
20 12 16 21 21 16 21 21 21 21 21 21 21 21 21 21 21 21 21 21 21 21 21 21 21 21 21 12 12 12 12 20
20 12 12 21 21 21 21 21 21 21 21 21 21 21 21 21 21 21 21 21 21 21 21 21 21 21 21 12 12 12 12 20
20 17 12 21 21 12 15 15 15 15 15 15 15 15 22 22 22 15 15 15 15 15 15 15 15 15 15 12 12 12 12 20
20 17 12 21 21 12 15 15 15 15 15 15 15 15 14 14 14 15 15 15 15 15 15 15 15 15 15 12 12 12 12 20
20 17 12 21 21 21 21 21 21 21 21 21 12 12 12 12 12 12 12 15 15 12 12 12 12 12 12 12 12 12 12 20
20 17 17 21 21 21 21 21 21 21 21 21 12 12 12 12 12 12 12 15 15 15 15 15 22 22 22 22 15 15 15 20
20 12 12 12 12 12 12 12 12 12 12 12 12 12 12 12 12 12 12 15 15 15 15 15 14 14 14 14 15 15 15 20
20 12 12 12 12 12 12 12 12 12 12 16 16 12 12 16 12 12 12 12 12 12 12 12 12 15 15 12 12 12 18 20
20 12 12 12 12 12 12 16 16 16 16 12 12 12 12 12 12 12 12 12 12 12 12 12 12 15 15 12 12 12 19 20
20 17 17 17 12 12 12 12 12 12 12 12 12 12 12 12 12 12 12 17 17 17 17 17 12 15 15 15 15 15 15 20
20 12 12 12 12 12 16 16 12 12 12 12 12 12 12 12 12 12 12 12 12 12 12 12 12 15 15 15 15 15 15 20
20 12 12 12 12 17 17 17 16 16 12 12 12 12 17 17 17 12 12 12 12 12 12 12 12 12 12 12 12 12 12 20
20 12 16 12 12 12 12 12 12 12 12 12 12 12 15 15 15 16 16 16 12 12 12 16 16 12 12 12 12 12 12 20
20 20 12 12 12 12 12 12 12 16 15 15 16 12 12 12 12 15 15 15 12 12 12 16 12 12 12 12 12 12 12 20
20 20 12 12 12 12 12 12 12 16 15 15 16 12 12 12 12 12 12 12 15 15 15 12 12 12 17 17 17 12 18 20
20 20 12 12 12 12 17 12 12 17 15 15 16 12 15 15 15 12 12 12 12 12 12 12 12 12 12 12 12 12 19 20
20 20 12 12 12 17 12 12 12 17 15 15 16 12 12 12 12 15 15 15 12 12 12 12 17 12 12 12 12 12 12 20
20 20 12 12 12 12 12 12 20 20 15 15 20 20 12 21 12 21 12 21 15 15 15 12 17 21 12 21 12 21 12 20
20 20 12 16 12 12 16 12 20 20 15 15 20 20 20 12 21 12 21 12 21 12 21 12 21 12 21 12 21 12 21 20
20 20 20 20 20 20 20 20 20 20 20 20 20 20 12 21 12 21 12 21 12 21 12 21 12 21 12 21 12 21 12 20
20 20 20 20 20 20 20 20 20 20 20 20 20 20 20 20 20 20 20 20 20 20 20 20 20 20 20 20 20 20 20 20