11 11 10 11 11 11 11 11 11 11 11 11 11 11 11 11 11 11 11 11 11 11 11 11 11 11 11 11 11 11
11 11 11 11 11 11 11 11 11 11 11 11 11 11 11 11 11 11 11 11 11 9 11 7 11 11 11 11 11 11
11 11 11 11 11 11 10 11 11 11 11 11 11 11 11 11 7 7 11 9 9 9 9 11 11 11 11 10 11 11
11 11 11 11 11 11 11 11 11 11 8 8 11 8 8 11 11 11 11 9 9 9 9 11 11 11 11 10 11 11
11 11 11 11 11 11 11 11 11 11 11 11 11 11 11 11 11 11 11 9 9 9 9 11 11 11 11 10 11 11
11 11 11 11 7 11 11 11 11 11 11 11 11 11 11 11 11 11 9 9 9 9 9 9 9 9 9 9 9 11
11 11 11 11 11 11 11 11 11 11 11 11 11 11 11 11 11 11 11 9 9 9 9 9 9 9 9 9 9 11
11 11 11 11 11 11 11 11 11 11 11 11 11 11 11 11 11 11 11 11 11 11 9 9 11 7 11 9 9 11
11 11 11 10 11 11 11 11 11 11 11 11 11 11 11 11 11 11 7 11 11 11 9 9 9 9 9 9 9 11
11 11 11 11 11 11 11 11 7 11 11 11 11 11 11 11 11 11 11 11 11 11 11 11 11 11 11 11 11 11
11 11 11 11 11 11 11 11 11 11 11 11 11 11 11 11 11 11 11 11 11 11 11 11 11 11 11 11 10 11
11 11 11 11 11 11 11 11 11 11 11 8 8 8 8 8 11 11 11 11 11 11 8 8 11 11 11 11 11 11
11 11 11 11 11 11 11 11 11 11 11 9 9 9 9 9 9 9 11 11 11 11 11 11 11 11 11 11 11 11
7 11 11 11 11 11 11 11 11 11 9 9 9 9 9 9 9 9 11 11 11 11 11 11 11 11 11 11 11 11
7 11 11 11 11 11 11 7 11 11 9 9 9 9 9 9 9 11 11 11 11 11 11 11 11 11 11 11 11 11
7 11 11 11 8 11 11 11 11 11 6 6 6 6 6 6 6 11 11 11 11 11 11 11 11 11 11 11 11 11
7 11 11 11 11 11 11 11 11 11 9 9 9 9 9 9 9 11 11 11 11 11 11 11 10 11 11 11 11 11
7 11 11 11 11 10 11 11 11 11 9 9 9 9 9 9 9 11 11 11 11 11 11 11 11 11 11 11 11 11
7 11 11 11 11 11 11 11 11 11 9 9 9 9 9 9 9 9 11 11 10 11 11 11 11 11 11 11 11 11
11 11 11 11 11 11 11 11 11 11 11 9 9 9 9 9 9 9 11 11 11 11 11 11 11 11 10 11 11 11
11 11 11 11 11 11 11 11 11 11 11 11 11 11 11 11 11 11 11 11 11 11 11 11 11 11 11 11 11 11
11 11 11 7 11 11 11 11 8 11 11 11 11 11 11 11 11 11 11 11 11 11 11 11 11 11 11 11 11 11
11 11 11 11 11 11 11 11 11 11 11 11 11 11 11 11 11 11 11 11 11 11 11 11 11 11 11 11 11 11
11 11 11 11 11 11 11 11 11 11 11 11 11 11 11 11 11 11 11 8 11 11 11 11 11 11 11 11 11 11
11 11 11 11 11 11 11 11 11 11 7 11 11 11 11 10 11 11 11 11 11 11 11 8 8 11 8 11 11 11
11 11 11 10 11 11 11 11 11 11 11 11 11 11 11 11 11 11 11 11 11 11 11 8 11 11 11 11 11 11
11 11 11 10 11 11 11 11 11 11 11 11 11 11 11 11 11 11 11 8 11 11 11 11 11 11 11 11 11 11
11 11 11 11 11 11 11 11 11 11 11 11 11 7 11 11 11 11 11 8 11 11 11 11 11 11 11 11 11 11
11 11 11 11 8 8 8 11 11 11 11 11 11 11 11 11 11 11 11 11 11 11 11 11 11 11 11 11 11 11
11 11 11 11 11 11 11 11 11 11 11 11 11 11 11 11 11 11 10 11 11 11 11 11 11 11 11 11 11 11
